20 20
11111111111111111111
1        F         1
1  1111111111111   1
1                  1
1 1  111111111  1  1
1 1             1  1
1 1  1       1  1  1
1   11111 11111    1
1   1         1    1
1   1 1 111 1 1    1
1     1  S  1      1
1   1 1 111 1 1    1
1   1         1    1
1   11111 11111    1
1 1  1       1  1  1
1 1             1  1
1 1  111111111  1  1
1                  1
1  11         11   1
11111111111111111111
