14 20
11111111111111111111
1S1   11           1
1 1 1  11111 11111 1
1 1 11 1   1 1     1
1 1 1  1 1 1 1 11111
1   1 11 1 1 1     1
11111    1   11111 1
1 1 1111 11111     1
1 1    1   1 1 11111
1   11 111 1 1   1 1
111  1 1   1   1 1 1
1  111 1 1111111 1 1
1    1        F1   1
11111111111111111111
