9 20
11111111111111111111
1S 1        11     1
1    111111  1 111 1
11 1   1    1   1  1
1  1 111 1111 111111
1 11 1        1    1
1  1 11 1 11111 1  1
11 1    1       1F 1
11111111111111111111
