14 20
11111111111111111111
1                 F1
1                  1
1                  1
1                  1
1                  1
1                  1
1        S         1
1                  1
1                  1
1                  1
1                  1
1                  1
11111111111111111111
