4
7
7
#######
#. $ .#
# $@$ #
#. $ .#
#######