90
20
16
####################
#..#    #          #
#.$  $  #$$  $## $##
#.$#  ###  ## ##   #
#  # $ #  $$   $   #
# ###  # #  #$  ####
#  ## # $   #@ #   #
# $    $  ##.##  $ #
#  # $# $# $     ###
#  #  #  #   ###   #
#  ######## #      #
#           #  #.#.#
##$########$#   ...#
#    .*  #    ##.#.#
# .*...*   $  .....#
####################