10 10
##########
#        #
#  S   W #
#        #
#  $     #
#        #
#@       #
#        #
#E     N #
##########