8 8
########
# @    #
#     X#
# XXX  #
#   XX #
#   XX #
#     $#
########