10 10
##########
#    I   #
#        #
#       $#
#       @#
#        #
#       I#
#        #
#        #
##########