8 8
########
#      #
# @    #
# XX   #
#  XX  #
#   XX #
#     $#
########