15 15
###############
#      IXXXXX #
#  @          #
#             #
#             #
#  I          #
#  B          #
#  B   S     W#
#  B   T      #
#             #
#         T   #
#         B   #
#            $#
#        XXXX #
###############