5 5
#####
#@  #
#   #
#  $#
#####